Zotu1	d:Bacteria,p:Actinobacteriota,c:Actinobacteria,o:Micrococcales,f:Micrococcaceae
Zotu5	d:Bacteria,p:Proteobacteria,c:Alphaproteobacteria,o:Rhizobiales,f:Methyloligellaceae,g:uncultured
Zotu6	d:Bacteria,p:Firmicutes,c:Bacilli,o:Bacillales,f:Bacillaceae,g:Bacillus
Zotu4	d:Bacteria,p:Proteobacteria,c:Alphaproteobacteria,o:Rhizobiales,f:Methyloligellaceae,g:uncultured
Zotu2	d:Bacteria,p:Actinobacteriota,c:Actinobacteria,o:Micrococcales,f:Micrococcaceae
Zotu3	d:Bacteria,p:Proteobacteria,c:Alphaproteobacteria,o:Rhizobiales,f:Methyloligellaceae,g:uncultured
Zotu7	d:Bacteria,p:Bacteroidota,c:Bacteroidia,o:Chitinophagales,f:Chitinophagaceae,g:uncultured
Zotu10	d:Bacteria,p:Bacteroidota,c:Bacteroidia,o:Cytophagales,f:Microscillaceae,g:uncultured
Zotu8	d:Bacteria,p:Actinobacteriota,c:MB-A2-108,o:MB-A2-108,f:MB-A2-108,g:MB-A2-108,s:uncultured_bacterium
Zotu9	d:Bacteria,p:Proteobacteria,c:Alphaproteobacteria,o:Rhizobiales,f:Methyloligellaceae,g:uncultured
Zotu12	d:Bacteria,p:Chloroflexi,c:Gitt-GS-136,o:Gitt-GS-136,f:Gitt-GS-136,g:Gitt-GS-136,s:uncultured_bacterium
Zotu11	d:Bacteria,p:Firmicutes,c:Bacilli,o:Bacillales,f:Bacillaceae,g:Bacillus
Zotu13	d:Bacteria,p:Firmicutes,c:Bacilli,o:Bacillales,f:Bacillaceae,g:Bacillus
Zotu14	d:Bacteria,p:Bacteroidota,c:Bacteroidia,o:Chitinophagales,f:Chitinophagaceae,g:uncultured
Zotu16	d:Bacteria,p:Actinobacteriota,c:MB-A2-108,o:MB-A2-108,f:MB-A2-108,g:MB-A2-108,s:uncultured_bacterium
Zotu17	d:Bacteria,p:Cyanobacteria,c:Cyanobacteriia,o:Chloroplast,f:Chloroplast,g:Chloroplast
Zotu15	d:Bacteria,p:Proteobacteria,c:Gammaproteobacteria,o:Burkholderiales,f:Sutterellaceae,g:uncultured,s:uncultured_bacterium
Zotu18	d:Bacteria,p:Nitrospirota,c:Nitrospiria,o:Nitrospirales,f:Nitrospiraceae,g:Nitrospira
Zotu20	d:Bacteria,p:Bacteroidota,c:Bacteroidia,o:Cytophagales,f:Microscillaceae,g:uncultured
Zotu23	d:Bacteria,p:Proteobacteria,c:Gammaproteobacteria,o:Burkholderiales,f:Sutterellaceae,g:uncultured,s:uncultured_bacterium
Zotu19	d:Bacteria,p:Firmicutes,c:Bacilli,o:Bacillales,f:Bacillaceae,g:Bacillus
Zotu22	d:Bacteria,p:Actinobacteriota,c:Acidimicrobiia,o:Microtrichales,f:Ilumatobacteraceae,g:Ilumatobacteraceae,s:uncultured_bacterium
Zotu21	d:Bacteria,p:Proteobacteria,c:Alphaproteobacteria,o:Rhizobiales,f:Xanthobacteraceae
Zotu24	d:Bacteria,p:Actinobacteriota,c:Actinobacteria,o:Propionibacteriales,f:Nocardioidaceae
Zotu26	d:Bacteria,p:Chloroflexi,c:Gitt-GS-136,o:Gitt-GS-136,f:Gitt-GS-136,g:Gitt-GS-136,s:uncultured_bacterium
Zotu25	d:Bacteria,p:Actinobacteriota,c:Acidimicrobiia,o:Microtrichales,f:Ilumatobacteraceae,g:Ilumatobacter
Zotu27	d:Bacteria,p:Actinobacteriota,c:Thermoleophilia,o:Gaiellales,f:Gaiellaceae
Zotu28	d:Bacteria,p:Nitrospirota,c:Nitrospiria,o:Nitrospirales,f:Nitrospiraceae,g:Nitrospira
Zotu29	d:Bacteria,p:Actinobacteriota,c:Actinobacteria,o:Propionibacteriales,f:Nocardioidaceae
Zotu30	d:Bacteria,p:Proteobacteria,c:Alphaproteobacteria,o:Rhizobiales,f:Xanthobacteraceae
Zotu31	d:Bacteria,p:Bacteroidota,c:Bacteroidia,o:Cytophagales,f:Microscillaceae,g:uncultured
Zotu32	d:Bacteria,p:Actinobacteriota,c:Acidimicrobiia,o:Microtrichales,f:Ilumatobacteraceae,g:Ilumatobacteraceae,s:uncultured_bacterium
Zotu34	d:Bacteria,p:Gemmatimonadota,c:Gemmatimonadetes,o:Gemmatimonadales,f:Gemmatimonadaceae,g:uncultured
Zotu33	d:Bacteria,p:Firmicutes,c:Bacilli,o:Bacillales,f:Bacillaceae,g:Bacillus
Zotu35	d:Bacteria,p:Actinobacteriota,c:Actinobacteria,o:Micrococcales,f:Micrococcaceae
Zotu36	d:Bacteria,p:Actinobacteriota,c:Acidimicrobiia,o:Microtrichales,f:Ilumatobacteraceae,g:Ilumatobacter
Zotu38	d:Bacteria,p:Cyanobacteria,c:Cyanobacteriia,o:Chloroplast,f:Chloroplast,g:Chloroplast
Zotu37	d:Bacteria,p:Firmicutes,c:Bacilli,o:Bacillales,f:Bacillaceae,g:Bacillus
Zotu40	d:Bacteria,p:Actinobacteriota,c:Thermoleophilia,o:Gaiellales,f:Gaiellaceae,g:Gaiella,s:uncultured_bacterium
Zotu41	d:Bacteria,p:Chloroflexi,c:Chloroflexia,o:Thermomicrobiales,f:JG30-KF-CM45,g:JG30-KF-CM45
Zotu39	d:Bacteria,p:Firmicutes,c:Bacilli,o:Bacillales,f:Bacillaceae,g:Bacillus
Zotu42	d:Bacteria,p:Firmicutes,c:Clostridia,o:Clostridiales,f:Clostridiaceae,g:Clostridium_sensu_stricto_13
Zotu44	d:Bacteria,p:Actinobacteriota,c:MB-A2-108,o:MB-A2-108,f:MB-A2-108,g:MB-A2-108,s:uncultured_bacterium
Zotu43	d:Bacteria,p:Proteobacteria,c:Alphaproteobacteria,o:Rhizobiales,f:Xanthobacteraceae,g:Bradyrhizobium
Zotu46	d:Bacteria,p:Bacteroidota,c:Bacteroidia,o:Cytophagales,f:Microscillaceae,g:uncultured
Zotu45	d:Bacteria,p:Proteobacteria,c:Alphaproteobacteria,o:Rhizobiales,f:Methyloligellaceae,g:uncultured
Zotu47	d:Bacteria,p:Proteobacteria,c:Gammaproteobacteria,o:Steroidobacterales,f:Steroidobacteraceae,g:uncultured
Zotu48	d:Bacteria,p:Nitrospirota,c:Nitrospiria,o:Nitrospirales,f:Nitrospiraceae,g:Nitrospira
Zotu49	d:Bacteria,p:Firmicutes,c:Bacilli,o:Bacillales,f:Bacillaceae,g:Bacillus
Zotu50	d:Bacteria,p:Actinobacteriota,c:Acidimicrobiia,o:Microtrichales,f:Ilumatobacteraceae,g:uncultured